EastAsian_sample1	EastAsian
EastAsian_sample2	EastAsian
EastAsian_sample3	EastAsian
EastAsian_sample4	EastAsian
EastAsian_sample5	EastAsian
EastAsian_sample6	EastAsian
EastAsian_sample7	EastAsian
EastAsian_sample8	EastAsian
EastAsian_sample9	EastAsian
EastAsian_sample10	EastAsian
EastAsian_sample11	EastAsian
EastAsian_sample12	EastAsian
EastAsian_sample13	EastAsian
EastAsian_sample14	EastAsian
EastAsian_sample15	EastAsian
EastAsian_sample16	EastAsian
EastAsian_sample17	EastAsian
EastAsian_sample18	EastAsian
EastAsian_sample19	EastAsian
EastAsian_sample20	EastAsian
Andamanese_sample1	Andamanese
Andamanese_sample2	Andamanese
Andamanese_sample3	Andamanese
Andamanese_sample4	Andamanese
Andamanese_sample5	Andamanese
Andamanese_sample6	Andamanese
Andamanese_sample7	Andamanese
Andamanese_sample8	Andamanese
Andamanese_sample9	Andamanese
Andamanese_sample10	Andamanese
Andamanese_sample11	Andamanese
Andamanese_sample12	Andamanese
Andamanese_sample13	Andamanese
Andamanese_sample14	Andamanese
Andamanese_sample15	Andamanese
Andamanese_sample16	Andamanese
Andamanese_sample17	Andamanese
Andamanese_sample18	Andamanese
Andamanese_sample19	Andamanese
Andamanese_sample20	Andamanese
SouthAmerican_Chaco_sample1	SouthAmerican
SouthAmerican_Chaco_sample2	SouthAmerican
SouthAmerican_Chaco_sample3	SouthAmerican
SouthAmerican_Chaco_sample4	SouthAmerican
SouthAmerican_Chaco_sample5	SouthAmerican
SouthAmerican_Chaco_sample6	SouthAmerican
SouthAmerican_Chaco_sample7	SouthAmerican
SouthAmerican_Chaco_sample8	SouthAmerican
SouthAmerican_Chaco_sample9	SouthAmerican
SouthAmerican_Chaco_sample10	SouthAmerican
SouthAmerican_Chaco_sample11	SouthAmerican
SouthAmerican_Chaco_sample12	SouthAmerican
SouthAmerican_Chaco_sample13	SouthAmerican
SouthAmerican_Chaco_sample14	SouthAmerican
SouthAmerican_Chaco_sample15	SouthAmerican
SouthAmerican_Chaco_sample16	SouthAmerican
SouthAmerican_Chaco_sample17	SouthAmerican
SouthAmerican_Chaco_sample18	SouthAmerican
SouthAmerican_Chaco_sample19	SouthAmerican
SouthAmerican_Chaco_sample20	SouthAmerican
NearEastern_sample1	NearEastern
NearEastern_sample2	NearEastern
NearEastern_sample3	NearEastern
NearEastern_sample4	NearEastern
NearEastern_sample5	NearEastern
NearEastern_sample6	NearEastern
NearEastern_sample7	NearEastern
NearEastern_sample8	NearEastern
NearEastern_sample9	NearEastern
NearEastern_sample10	NearEastern
NearEastern_sample11	NearEastern
NearEastern_sample12	NearEastern
NearEastern_sample13	NearEastern
NearEastern_sample14	NearEastern
NearEastern_sample15	NearEastern
NearEastern_sample16	NearEastern
NearEastern_sample17	NearEastern
NearEastern_sample18	NearEastern
NearEastern_sample19	NearEastern
NearEastern_sample20	NearEastern
Dravidian_sample1	Dravidian
Dravidian_sample2	Dravidian
Dravidian_sample3	Dravidian
Dravidian_sample4	Dravidian
Dravidian_sample5	Dravidian
Dravidian_sample6	Dravidian
Dravidian_sample7	Dravidian
Dravidian_sample8	Dravidian
Dravidian_sample9	Dravidian
Dravidian_sample10	Dravidian
Dravidian_sample11	Dravidian
Dravidian_sample12	Dravidian
Dravidian_sample13	Dravidian
Dravidian_sample14	Dravidian
Dravidian_sample15	Dravidian
Dravidian_sample16	Dravidian
Dravidian_sample17	Dravidian
Dravidian_sample18	Dravidian
Dravidian_sample19	Dravidian
Dravidian_sample20	Dravidian
PapuanBaining_sample1	PapuanBaining
PapuanBaining_sample2	PapuanBaining
PapuanBaining_sample3	PapuanBaining
PapuanBaining_sample4	PapuanBaining
PapuanBaining_sample5	PapuanBaining
PapuanBaining_sample6	PapuanBaining
PapuanBaining_sample7	PapuanBaining
PapuanBaining_sample8	PapuanBaining
PapuanBaining_sample9	PapuanBaining
PapuanBaining_sample10	PapuanBaining
PapuanBaining_sample11	PapuanBaining
PapuanBaining_sample12	PapuanBaining
PapuanBaining_sample13	PapuanBaining
PapuanBaining_sample14	PapuanBaining
PapuanBaining_sample15	PapuanBaining
PapuanBaining_sample16	PapuanBaining
PapuanBaining_sample17	PapuanBaining
PapuanBaining_sample18	PapuanBaining
PapuanBaining_sample19	PapuanBaining
PapuanBaining_sample20	PapuanBaining
Papuan_sample1	Papuan
Papuan_sample2	Papuan
Papuan_sample3	Papuan
Papuan_sample4	Papuan
Papuan_sample5	Papuan
Papuan_sample6	Papuan
Papuan_sample7	Papuan
Papuan_sample8	Papuan
Papuan_sample9	Papuan
Papuan_sample10	Papuan
Papuan_sample11	Papuan
Papuan_sample12	Papuan
Papuan_sample13	Papuan
Papuan_sample14	Papuan
Papuan_sample15	Papuan
Papuan_sample16	Papuan
Papuan_sample17	Papuan
Papuan_sample18	Papuan
Papuan_sample19	Papuan
Papuan_sample20	Papuan
Yeniseyan_sample1	Yeniseyan
Yeniseyan_sample2	Yeniseyan
Yeniseyan_sample3	Yeniseyan
Yeniseyan_sample4	Yeniseyan
Yeniseyan_sample5	Yeniseyan
Yeniseyan_sample6	Yeniseyan
Yeniseyan_sample7	Yeniseyan
Yeniseyan_sample8	Yeniseyan
Yeniseyan_sample9	Yeniseyan
Yeniseyan_sample10	Yeniseyan
Yeniseyan_sample11	Yeniseyan
Yeniseyan_sample12	Yeniseyan
Yeniseyan_sample13	Yeniseyan
Yeniseyan_sample14	Yeniseyan
Yeniseyan_sample15	Yeniseyan
Yeniseyan_sample16	Yeniseyan
Yeniseyan_sample17	Yeniseyan
Yeniseyan_sample18	Yeniseyan
Yeniseyan_sample19	Yeniseyan
Yeniseyan_sample20	Yeniseyan
Amazonian_sample1	Amazonian
Amazonian_sample2	Amazonian
Amazonian_sample3	Amazonian
Amazonian_sample4	Amazonian
Amazonian_sample5	Amazonian
Amazonian_sample6	Amazonian
Amazonian_sample7	Amazonian
Amazonian_sample8	Amazonian
Amazonian_sample9	Amazonian
Amazonian_sample10	Amazonian
Amazonian_sample11	Amazonian
Amazonian_sample12	Amazonian
Amazonian_sample13	Amazonian
Amazonian_sample14	Amazonian
Amazonian_sample15	Amazonian
Amazonian_sample16	Amazonian
Amazonian_sample17	Amazonian
Amazonian_sample18	Amazonian
Amazonian_sample19	Amazonian
Amazonian_sample20	Amazonian
BrazilianYanomami_sample1	BrazilianYanomami
BrazilianYanomami_sample2	BrazilianYanomami
BrazilianYanomami_sample3	BrazilianYanomami
BrazilianYanomami_sample4	BrazilianYanomami
BrazilianYanomami_sample5	BrazilianYanomami
BrazilianYanomami_sample6	BrazilianYanomami
BrazilianYanomami_sample7	BrazilianYanomami
BrazilianYanomami_sample8	BrazilianYanomami
BrazilianYanomami_sample9	BrazilianYanomami
BrazilianYanomami_sample10	BrazilianYanomami
BrazilianYanomami_sample11	BrazilianYanomami
BrazilianYanomami_sample12	BrazilianYanomami
BrazilianYanomami_sample13	BrazilianYanomami
BrazilianYanomami_sample14	BrazilianYanomami
BrazilianYanomami_sample15	BrazilianYanomami
BrazilianYanomami_sample16	BrazilianYanomami
BrazilianYanomami_sample17	BrazilianYanomami
BrazilianYanomami_sample18	BrazilianYanomami
BrazilianYanomami_sample19	BrazilianYanomami
BrazilianYanomami_sample20	BrazilianYanomami
PlillippinoNegrito_sample1	PlillippinoNegrito
PlillippinoNegrito_sample2	PlillippinoNegrito
PlillippinoNegrito_sample3	PlillippinoNegrito
PlillippinoNegrito_sample4	PlillippinoNegrito
PlillippinoNegrito_sample5	PlillippinoNegrito
PlillippinoNegrito_sample6	PlillippinoNegrito
PlillippinoNegrito_sample7	PlillippinoNegrito
PlillippinoNegrito_sample8	PlillippinoNegrito
PlillippinoNegrito_sample9	PlillippinoNegrito
PlillippinoNegrito_sample10	PlillippinoNegrito
PlillippinoNegrito_sample11	PlillippinoNegrito
PlillippinoNegrito_sample12	PlillippinoNegrito
PlillippinoNegrito_sample13	PlillippinoNegrito
PlillippinoNegrito_sample14	PlillippinoNegrito
PlillippinoNegrito_sample15	PlillippinoNegrito
PlillippinoNegrito_sample16	PlillippinoNegrito
PlillippinoNegrito_sample17	PlillippinoNegrito
PlillippinoNegrito_sample18	PlillippinoNegrito
PlillippinoNegrito_sample19	PlillippinoNegrito
PlillippinoNegrito_sample20	PlillippinoNegrito
Eskimo_sample1	Eskimo
Eskimo_sample2	Eskimo
Eskimo_sample3	Eskimo
Eskimo_sample4	Eskimo
Eskimo_sample5	Eskimo
Eskimo_sample6	Eskimo
Eskimo_sample7	Eskimo
Eskimo_sample8	Eskimo
Eskimo_sample9	Eskimo
Eskimo_sample10	Eskimo
Eskimo_sample11	Eskimo
Eskimo_sample12	Eskimo
Eskimo_sample13	Eskimo
Eskimo_sample14	Eskimo
Eskimo_sample15	Eskimo
Eskimo_sample16	Eskimo
Eskimo_sample17	Eskimo
Eskimo_sample18	Eskimo
Eskimo_sample19	Eskimo
Eskimo_sample20	Eskimo
SouthAmerican_Quechua_sample1	SouthAmerican
SouthAmerican_Quechua_sample2	SouthAmerican
SouthAmerican_Quechua_sample3	SouthAmerican
SouthAmerican_Quechua_sample4	SouthAmerican
SouthAmerican_Quechua_sample5	SouthAmerican
SouthAmerican_Quechua_sample6	SouthAmerican
SouthAmerican_Quechua_sample7	SouthAmerican
SouthAmerican_Quechua_sample8	SouthAmerican
SouthAmerican_Quechua_sample9	SouthAmerican
SouthAmerican_Quechua_sample10	SouthAmerican
SouthAmerican_Quechua_sample11	SouthAmerican
SouthAmerican_Quechua_sample12	SouthAmerican
SouthAmerican_Quechua_sample13	SouthAmerican
SouthAmerican_Quechua_sample14	SouthAmerican
SouthAmerican_Quechua_sample15	SouthAmerican
SouthAmerican_Quechua_sample16	SouthAmerican
SouthAmerican_Quechua_sample17	SouthAmerican
SouthAmerican_Quechua_sample18	SouthAmerican
SouthAmerican_Quechua_sample19	SouthAmerican
SouthAmerican_Quechua_sample20	SouthAmerican
EastIndian_sample1	EastIndian
EastIndian_sample2	EastIndian
EastIndian_sample3	EastIndian
EastIndian_sample4	EastIndian
EastIndian_sample5	EastIndian
EastIndian_sample6	EastIndian
EastIndian_sample7	EastIndian
EastIndian_sample8	EastIndian
EastIndian_sample9	EastIndian
EastIndian_sample10	EastIndian
EastIndian_sample11	EastIndian
EastIndian_sample12	EastIndian
EastIndian_sample13	EastIndian
EastIndian_sample14	EastIndian
EastIndian_sample15	EastIndian
EastIndian_sample16	EastIndian
EastIndian_sample17	EastIndian
EastIndian_sample18	EastIndian
EastIndian_sample19	EastIndian
EastIndian_sample20	EastIndian
Malaysian_sample1	Malaysian
Malaysian_sample2	Malaysian
Malaysian_sample3	Malaysian
Malaysian_sample4	Malaysian
Malaysian_sample5	Malaysian
Malaysian_sample6	Malaysian
Malaysian_sample7	Malaysian
Malaysian_sample8	Malaysian
Malaysian_sample9	Malaysian
Malaysian_sample10	Malaysian
Malaysian_sample11	Malaysian
Malaysian_sample12	Malaysian
Malaysian_sample13	Malaysian
Malaysian_sample14	Malaysian
Malaysian_sample15	Malaysian
Malaysian_sample16	Malaysian
Malaysian_sample17	Malaysian
Malaysian_sample18	Malaysian
Malaysian_sample19	Malaysian
Malaysian_sample20	Malaysian
SubSaharanAfrican_sample1	SubSaharanAfrican
SubSaharanAfrican_sample2	SubSaharanAfrican
SubSaharanAfrican_sample3	SubSaharanAfrican
SubSaharanAfrican_sample4	SubSaharanAfrican
SubSaharanAfrican_sample5	SubSaharanAfrican
SubSaharanAfrican_sample6	SubSaharanAfrican
SubSaharanAfrican_sample7	SubSaharanAfrican
SubSaharanAfrican_sample8	SubSaharanAfrican
SubSaharanAfrican_sample9	SubSaharanAfrican
SubSaharanAfrican_sample10	SubSaharanAfrican
SubSaharanAfrican_sample11	SubSaharanAfrican
SubSaharanAfrican_sample12	SubSaharanAfrican
SubSaharanAfrican_sample13	SubSaharanAfrican
SubSaharanAfrican_sample14	SubSaharanAfrican
SubSaharanAfrican_sample15	SubSaharanAfrican
SubSaharanAfrican_sample16	SubSaharanAfrican
SubSaharanAfrican_sample17	SubSaharanAfrican
SubSaharanAfrican_sample18	SubSaharanAfrican
SubSaharanAfrican_sample19	SubSaharanAfrican
SubSaharanAfrican_sample20	SubSaharanAfrican
NorthernEuropean_sample1	NorthernEuropean
NorthernEuropean_sample2	NorthernEuropean
NorthernEuropean_sample3	NorthernEuropean
NorthernEuropean_sample4	NorthernEuropean
NorthernEuropean_sample5	NorthernEuropean
NorthernEuropean_sample6	NorthernEuropean
NorthernEuropean_sample7	NorthernEuropean
NorthernEuropean_sample8	NorthernEuropean
NorthernEuropean_sample9	NorthernEuropean
NorthernEuropean_sample10	NorthernEuropean
NorthernEuropean_sample11	NorthernEuropean
NorthernEuropean_sample12	NorthernEuropean
NorthernEuropean_sample13	NorthernEuropean
NorthernEuropean_sample14	NorthernEuropean
NorthernEuropean_sample15	NorthernEuropean
NorthernEuropean_sample16	NorthernEuropean
NorthernEuropean_sample17	NorthernEuropean
NorthernEuropean_sample18	NorthernEuropean
NorthernEuropean_sample19	NorthernEuropean
NorthernEuropean_sample20	NorthernEuropean
Austronesian_sample1	Austronesian
Austronesian_sample2	Austronesian
Austronesian_sample3	Austronesian
Austronesian_sample4	Austronesian
Austronesian_sample5	Austronesian
Austronesian_sample6	Austronesian
Austronesian_sample7	Austronesian
Austronesian_sample8	Austronesian
Austronesian_sample9	Austronesian
Austronesian_sample10	Austronesian
Austronesian_sample11	Austronesian
Austronesian_sample12	Austronesian
Austronesian_sample13	Austronesian
Austronesian_sample14	Austronesian
Austronesian_sample15	Austronesian
Austronesian_sample16	Austronesian
Austronesian_sample17	Austronesian
Austronesian_sample18	Austronesian
Austronesian_sample19	Austronesian
Austronesian_sample20	Austronesian
GA002786    QuechuaCandelaria_3
GA003530	Atacama_3
GA000130	Uyghur_0
GA002973	Chaco_Lengua_0
